{
    "total_time": "1.0",
    "columns": "5",
    "rows": "9",
    "timeframes": [
        "11x11
         11011
         11x11
         11011
         11x11
         11011
         11x11
         11011
         11x11",

        "11011
         11011
         11011
         11011
         11011
         11011
         11011
         11011
         11011",
        
        "11011
         11011
         11011
         11011
         11011
         11011
         11011
         11011
         11011",
        
        "11011
         11011
         11011
         11011
         11011
         11011
         11011
         11011
         11011",
        
        "11011
         11011
         11011
         11011
         11011
         11011
         11011
         11011
         11011",

        "11011
         11x11
         11011
         11x11
         11011
         11x11
         11011
         11x11
         11011",

        "11011
         11011
         11011
         11011
         11011
         11011
         11011
         11011
         11011",

        "11011
         11011
         11011
         11011
         11011
         11011
         11011
         11011
         11011",

        "11011
         11011
         11011
         11011
         11011
         11011
         11011
         11011
         11011",

        "11011
         11011
         11011
         11011
         11011
         11011
         11011
         11011
         11011"
    ]
}
